00000000000000000000000000000000000000000000000000000000000111111111111111
00000000000000000000000000000000000000000000000000000000000111111111111111
00000000000000000000000000000000000000000000000000000000000111111111111111
00000000000000000000000000000000000000000000000000000000000111111111111111
000011111S1111110000000000000000000000000000000000000000000111111111111111
00001111111111110000000000000000000000000000000000000000000111111111111111
00001111111111110000000000000000000000000000000000000000000111111111111111
00001111111111110000000000000000000000000000000000000000000111111111111111
000011111*1111110000000000000000000000000000000000000000000111111111111111
00001111111111110000000000000000000000000000000000000000000111111111111111
000000000110000000000000000000000000000000000000000000000000000E1000000000
000000000T111110011B111110011000011111111111100111111111T11110011000000000
000000000!1111100111111110011000011111111111100111111111111110011000000000
000000000111011001100111111111111T1000000001100110000000000000011000000000
00000000011001100110011111111111111001100111100110011111100111111000000000
00000000011001100110000000000000000001100110000110011001100001111000000000
0000000001100110011111100111111111111111111T11B110011001110000011000000000
000000000110011001100000011000000000000000000000000110000001111T1000000000
00000000011001100110011111100001100111111111011110011110011111111000000000
0000000001100110011001T000000001100110000000011110000110000000011000000000
000000000110011001100111111111111001111111T1111111100111111110011000000000
00000000000001100000000110000000000000000001100000000110000000011000000000
0000000001111110011B1001100001111111T1111111100110011111111110011000000000
00000000011110000110000110000110000000000000000110000000000110011000000000
00000000011111111110011110000111111001111111100110011111111110011000000000
00000000011001100000011000000000011001100111111110011110000000011000000000
0000000001100111111T111001111110011001100000011110000111111110011000000000
00000000011001111000000001100110011001100B10011111100000000110011000000000
00000000011001111110011111100110011111100110011111111111111110011000000000
00000000011000000000011110000110011000000111111110011111100110011000000000
00000000011111111111111000011110011111100111111110011111100000011000000000
00000000000000000000000001111000011110000000000000000001111110011000000000
00000000011111111111111111111001111110011111111110011111111110011000000000
00000000011000011001100000000001100000011000000110011000000000011000000000
00000000011001111001111111111111100110011001111110011001111110011000000000
00000000011000000000000000000000000110011001100000000001100110011000000000
000000000B1110011111100111111111100110011001100111111111100110011000000000
00000000000110011001100111100111100110011001100110000000000110011000000000
0000000001111111100111111110011111T11111100111111001111111111T111000000000
00000000000000000000000000000000000000000000000000000000000000000000000000
00000000000000000000000000000000000000000000000000000000000000000000000000
00000000000000000000000000000000000000000000000000000000000000000000000000
00000000000000000000000000000000000000000000000000000000000000000000000000
00000000000000000000000000000000000000000000000000000000000000000000000000
