00S10000000000000000000000000000000000000000000000000000E100
00T111110011B111110011000011111111111100111111111T1111001100
001111110011111111001100001111111111110011111111111111001100
00111011001100111111111111T100000000110011000000000000001100
001100110011001111111111111100110011110011001111110011111100
001100110011000000000000000000110011000011001100110000111100
001100110011111100111111111111111111T11B11001100111000001100
00110011001100000011000000000000000000000000110000001111T100
001100110011001111110000110011111111101111001111001111111100
001100110011001T00000000110011000000001111000011000000001100
00110011001100111111111111001111111T111111110011111111001100
000000110000000011000000000000000000110000000011000000001100
001111110011B1001100001111111T111111110011001111111111001100
001111000011000011000011000000000000000011000000000011001100
001111111111001111000011111100111111110011001111111111001100
001100110000001100000000001100110011111111001111000000001100
001100111111T11100111111001100110000001111000011111111001100
0011001111000000001100110011001100B1001111110000000011001100
001100111111001111110011001111110011001111111111111111001100
001100000000001111000011001100000011111111001111110011001100
001111111111111100001111001111110011111111001111110000001100
000000000000000000111100001111000000000000000000111111001100
001111111111111111111100111111001111111111001111111111001100
001100001100110000000000110000001100000011001100000000001100
001100111100111111111111110011001100111111001100111111001100
001100000000000000000000000011001100110000000000110011001100
00B111001111110011111111110011001100110011111111110011001100
000011001100110011110011110011001100110011000000000011001100
001111111100111111110011111T11111100111111001111111111T11100
000000000000000000000000000000000000000000000000000000000000
