01000000000000
01111100000000
01000111100000
01000000111110
01000000100000
01111111100000
00010000000000
00011110000000
00000100000000
00111111111100
00100000001000
00111111111000
00000000001110
00000000001000